date,geography,geography code,Living arrangements: Total; measures: Value,Living arrangements: Living in a couple; measures: Value,Living arrangements: Living in a couple: Married or in a civil partnership; measures: Value,Living arrangements: Living in a couple: Married or in a civil partnership: Opposite-sex couple; measures: Value,Living arrangements: Living in a couple: Married or in a civil partnership: Same-sex couple; measures: Value,"Living arrangements: Living in a couple: Separated, but still married or in a civil partnership; measures: Value",Living arrangements: Living in a couple: Cohabiting; measures: Value,Living arrangements: Living in a couple: Cohabiting: Opposite-sex couple; measures: Value,Living arrangements: Living in a couple: Cohabiting: Same-sex couple; measures: Value,Living arrangements: Not living in a couple; measures: Value,Living arrangements: Not living in a couple: Single (never married and never registered a same-sex civil partnership); measures: Value,Living arrangements: Not living in a couple: Married or in a registered civil partnership; measures: Value,Living arrangements: Not living in a couple: Separated (including those who are married and those who are in civil partnerships); measures: Value,Living arrangements: Not living in a couple: Divorced or formerly in a civil partnership which is now legally dissolved; measures: Value,Living arrangements: Not living in a couple: Widowed or surviving partner from a civil partnership; measures: Value
2021,Bolton 001,E02000984,6372,4374,3544,3522,22,4,826,800,26,1998,1220,51,90,303,334
2021,Bolton 002,E02000985,6211,4118,3370,3352,18,4,744,712,32,2093,1196,32,75,344,446
2021,Bolton 003,E02000986,6837,4202,3220,3208,12,2,980,945,35,2635,1496,73,124,494,448
2021,Bolton 004,E02000987,6024,3274,2226,2201,25,2,1046,1006,40,2750,1612,48,127,565,398
2021,Bolton 005,E02000988,7042,3734,2918,2904,14,4,812,776,36,3308,2104,121,145,499,439
2021,Bolton 006,E02000989,7075,4644,3699,3679,20,9,936,906,30,2431,1267,43,96,402,623
2021,Bolton 007,E02000990,6915,4371,3224,3205,19,3,1144,1092,52,2544,1566,48,127,423,380
2021,Bolton 008,E02000991,6207,3832,2936,2922,14,4,892,844,48,2375,1449,78,118,372,358
2021,Bolton 009,E02000992,5158,3308,2458,2444,14,2,848,816,32,1850,1043,28,79,346,354
2021,Bolton 010,E02000993,6246,3058,1973,1965,8,9,1076,1034,42,3188,2121,46,142,579,300
2021,Bolton 011,E02000994,6643,3309,2699,2691,8,7,603,544,59,3334,2108,241,162,507,316
2021,Bolton 012,E02000995,6475,3786,2981,2961,20,7,798,770,28,2689,1633,57,105,497,397
2021,Bolton 013,E02000996,6226,3043,1975,1966,9,12,1056,1008,48,3183,2152,43,143,517,328
2021,Bolton 014,E02000997,5192,3257,2530,2516,14,2,725,698,27,1935,1150,46,94,347,298
2021,Bolton 015,E02000998,7680,3794,3104,3092,12,6,684,650,34,3886,2620,276,181,483,326
2021,Bolton 016,E02000999,6252,2583,2005,1997,8,6,572,522,50,3669,2376,187,181,562,363
2021,Bolton 017,E02001000,7254,3752,2569,2553,16,9,1174,1112,62,3502,2134,156,175,572,465
2021,Bolton 018,E02001001,6528,3758,3072,3064,8,0,686,646,40,2770,1723,177,150,389,331
2021,Bolton 019,E02001002,7670,4380,3199,3175,24,5,1176,1138,38,3290,2101,59,153,538,439
2021,Bolton 020,E02001003,6003,3917,3478,3466,12,11,428,410,18,2086,1208,147,77,242,412
2021,Bolton 021,E02001004,6764,3339,2919,2917,2,5,415,386,29,3425,2214,274,140,421,376
2021,Bolton 022,E02001005,7081,3674,2934,2920,14,4,736,678,58,3407,2214,333,133,372,355
2021,Bolton 023,E02001006,6173,3435,3006,3004,2,4,425,416,9,2738,1854,197,107,296,284
2021,Bolton 024,E02001007,8333,4961,3854,3840,14,7,1100,1074,26,3372,1899,48,185,588,652
2021,Bolton 025,E02001008,6271,3272,2864,2858,6,2,406,390,16,2999,2007,178,149,360,305
2021,Bolton 026,E02001009,5668,3157,2520,2511,9,3,634,608,26,2511,1561,102,121,395,332
2021,Bolton 027,E02001010,4865,2552,1808,1798,10,4,740,712,28,2313,1513,119,120,323,238
2021,Bolton 028,E02001011,8087,5262,4065,4043,22,3,1194,1150,44,2825,1600,60,137,561,467
2021,Bolton 029,E02001012,7074,4070,3377,3365,12,1,692,670,22,3004,2001,152,122,369,360
2021,Bolton 030,E02001013,4950,3206,2615,2611,4,7,584,574,10,1744,1010,65,90,247,332
2021,Bolton 031,E02001014,6846,3858,2715,2687,28,5,1138,1094,44,2988,1785,55,136,619,393
2021,Bolton 032,E02001015,6559,3217,2056,2026,30,8,1153,1102,51,3342,1929,66,199,683,465
2021,Bolton 033,E02001016,6499,3327,2212,2190,22,6,1109,1082,27,3172,2166,74,167,439,326
2021,Bolton 034,E02001017,8679,4941,3372,3349,23,15,1554,1516,38,3738,2326,62,168,620,562
2021,Bolton 035,E02001018,6242,4098,3151,3137,14,1,946,918,28,2144,1349,46,97,368,284
2021,Bury 001,E02001019,7291,4390,3144,3130,14,6,1240,1196,44,2901,1700,45,142,604,410
2021,Bury 002,E02001020,4956,3406,2935,2929,6,3,468,458,10,1550,864,27,43,221,395
2021,Bury 003,E02001021,6173,4119,3365,3337,28,8,746,720,26,2054,1211,31,99,360,353
2021,Bury 004,E02001022,6446,3763,2854,2820,34,4,905,862,43,2683,1578,96,127,433,449
2021,Bury 005,E02001023,4549,2794,2245,2236,9,3,546,526,20,1755,1055,51,79,279,291
2021,Bury 006,E02001024,6558,4226,3239,3225,14,5,982,954,28,2332,1401,29,108,409,385
2021,Bury 007,E02001025,6199,3178,2267,2247,20,13,898,850,48,3021,1951,113,156,489,312
2021,Bury 008,E02001026,8513,4276,3152,3138,14,6,1118,1030,88,4237,2737,339,221,583,357
2021,Bury 009,E02001027,5621,3002,1982,1964,18,2,1018,970,48,2619,1666,47,121,516,269
2021,Bury 010,E02001028,6140,4226,3682,3675,7,12,532,514,18,1914,1019,47,65,281,502
2021,Bury 011,E02001029,5932,3156,2452,2440,12,4,700,656,44,2776,1728,188,135,415,310
2021,Bury 012,E02001030,5103,3355,2598,2585,13,9,748,718,30,1748,1139,35,62,269,243
2021,Bury 013,E02001031,5471,2980,2272,2254,18,4,704,682,22,2491,1494,90,129,438,340
2021,Bury 014,E02001032,6150,3632,2587,2567,20,7,1038,1004,34,2518,1547,30,107,435,399
2021,Bury 015,E02001033,4848,2676,1764,1748,16,0,912,886,26,2172,1340,63,143,408,218
2021,Bury 016,E02001034,6740,3022,1925,1911,14,3,1094,1040,54,3718,2386,75,203,682,372
2021,Bury 017,E02001035,5982,3736,3062,3052,10,0,674,646,28,2246,1358,50,85,316,437
2021,Bury 018,E02001036,5873,3402,2374,2352,22,7,1021,978,43,2471,1596,41,146,411,277
2021,Bury 019,E02001037,5865,3888,3200,3192,8,6,682,638,44,1977,1160,46,74,300,397
2021,Bury 020,E02001038,4691,2499,1747,1728,19,2,750,682,68,2192,1313,45,98,429,307
2021,Bury 021,E02001039,6588,3406,2341,2325,16,7,1058,994,64,3182,2100,67,159,470,386
2021,Bury 022,E02001040,5066,3150,2376,2340,36,2,772,728,44,1916,1170,38,94,302,312
2021,Bury 023,E02001041,6280,3431,2219,2187,32,2,1210,1120,90,2849,1780,75,140,451,403
2021,Bury 024,E02001042,5290,3088,2408,2372,36,4,676,612,64,2202,1392,55,82,370,303
2021,Bury 025,E02001043,4468,2554,1832,1808,24,8,714,672,42,1914,1228,56,88,305,237
2021,Bury 026,E02001044,6368,3910,3502,3490,12,8,400,368,32,2458,1711,137,68,267,275
2021,Manchester 001,E02001045,6443,2798,1921,1895,26,5,872,826,46,3645,2430,91,196,533,395
2021,Manchester 002,E02001046,8362,4092,2880,2836,44,2,1210,1102,108,4270,3061,143,205,536,325
2021,Manchester 003,E02001047,8010,3642,2601,2591,10,5,1036,980,56,4368,2995,105,238,611,419
2021,Manchester 004,E02001048,6963,3680,3033,3009,24,5,642,592,50,3283,2159,191,171,448,314
2021,Manchester 005,E02001049,8071,4098,2930,2910,20,4,1164,1102,62,3973,2692,94,193,505,489
2021,Manchester 006,E02001050,5854,2619,1951,1928,23,6,662,622,40,3235,2176,178,192,452,237
2021,Manchester 007,E02001051,6743,3131,2323,2307,16,8,800,764,36,3612,2486,194,223,407,302
2021,Manchester 008,E02001052,10408,5149,4564,4548,16,33,552,488,64,5259,3362,720,236,510,431
2021,Manchester 009,E02001053,8392,3228,2330,2312,18,20,878,798,80,5164,3697,227,295,622,323
2021,Manchester 011,E02001055,6960,2932,1975,1947,28,11,946,880,66,4028,2773,120,242,555,338
2021,Manchester 012,E02001056,6405,2482,1693,1691,2,11,778,732,46,3923,2700,177,220,490,336
2021,Manchester 015,E02001059,8770,3844,2604,2561,43,11,1229,1114,115,4926,3534,220,283,578,311
2021,Manchester 017,E02001061,8064,3508,2473,2455,18,9,1026,976,50,4556,3102,217,250,613,374
2021,Manchester 018,E02001062,6980,2624,2019,1997,22,11,594,544,50,4356,3306,260,190,415,185
2021,Manchester 019,E02001063,6305,2092,1311,1255,56,13,768,664,104,4213,3485,183,118,314,113
2021,Manchester 020,E02001064,7714,3462,2791,2783,8,11,660,586,74,4252,2904,309,200,530,309
2021,Manchester 021,E02001065,7013,3299,2280,2276,4,4,1015,946,69,3714,2545,217,189,454,309
2021,Manchester 022,E02001066,8099,2848,2328,2320,8,4,516,456,60,5251,4183,415,147,293,213
2021,Manchester 023,E02001067,8110,3538,2604,2586,18,18,916,858,58,4572,3172,277,264,551,308
2021,Manchester 024,E02001068,8366,2874,2272,2240,32,6,596,534,62,5492,3915,407,268,579,323
2021,Manchester 025,E02001069,9157,3040,2291,2257,34,17,732,649,83,6117,4876,414,204,385,238
2021,Manchester 026,E02001070,7590,2682,2156,2134,22,10,516,446,70,4908,3856,397,140,297,218
2021,Manchester 028,E02001072,7231,3276,2128,2080,48,4,1144,1010,134,3955,2988,218,136,433,180
2021,Manchester 029,E02001073,7768,4017,2598,2489,109,7,1412,1280,132,3751,2846,135,114,376,280
2021,Manchester 030,E02001074,8909,3808,3007,2959,48,11,790,730,60,5101,3794,218,184,518,387
2021,Manchester 031,E02001075,6907,3370,2288,2254,34,6,1076,968,108,3537,2521,285,174,348,209
2021,Manchester 032,E02001076,8071,1722,1229,1211,18,3,490,422,68,6349,5864,133,55,165,132
2021,Manchester 033,E02001077,6132,3254,2142,2060,82,0,1112,980,132,2878,2124,143,86,286,239
2021,Manchester 034,E02001078,8385,4400,3478,3426,52,4,918,848,70,3985,2782,206,161,394,442
2021,Manchester 035,E02001079,7668,2645,1878,1861,17,3,764,708,56,5023,4015,193,137,386,292
2021,Manchester 036,E02001080,8777,2188,1318,1306,12,6,864,776,88,6589,5905,103,98,264,219
2021,Manchester 037,E02001081,5137,2991,1889,1806,83,4,1098,986,112,2146,1540,37,79,278,212
2021,Manchester 038,E02001082,5814,2459,1430,1394,36,2,1027,952,75,3355,2888,73,74,199,121
2021,Manchester 039,E02001083,7068,3484,1579,1541,38,3,1902,1790,112,3584,3017,59,83,315,110
2021,Manchester 040,E02001084,7206,3055,2148,2088,60,0,907,846,61,4151,3414,77,103,310,247
2021,Manchester 041,E02001085,6618,2945,2176,2160,16,8,761,744,17,3673,2625,109,182,435,322
2021,Manchester 042,E02001086,5428,2600,1550,1510,40,6,1044,988,56,2828,2055,93,118,340,222
2021,Manchester 043,E02001087,7734,4632,3087,3039,48,1,1544,1446,98,3102,2203,79,91,392,337
2021,Manchester 044,E02001088,6860,3350,2246,2228,18,12,1092,1054,38,3510,2411,86,165,515,333
2021,Manchester 045,E02001089,6498,3934,2913,2877,36,7,1014,944,70,2564,1778,84,74,303,325
2021,Manchester 046,E02001090,5783,3145,2186,2152,34,1,958,916,42,2638,1719,90,117,390,322
2021,Manchester 047,E02001091,6781,3498,2397,2375,22,3,1098,1046,52,3283,2109,70,127,602,375
2021,Manchester 048,E02001092,7063,3358,2338,2322,16,4,1016,940,76,3705,2612,110,170,491,322
2021,Manchester 049,E02001093,7168,3350,2088,2080,8,12,1250,1190,60,3818,2709,90,218,509,292
2021,Manchester 050,E02001094,7154,3062,1888,1878,10,18,1156,1052,104,4092,2871,131,216,557,317
2021,Manchester 051,E02001095,6963,3120,1989,1971,18,7,1124,1054,70,3843,2628,107,152,585,371
2021,Manchester 052,E02001096,6394,3084,2105,2087,18,3,976,928,48,3310,2304,79,136,473,318
2021,Manchester 053,E02001097,6562,2987,1866,1850,16,7,1114,1070,44,3575,2499,68,164,542,302
2021,Manchester 054,E02006902,6991,2764,976,904,72,4,1784,1562,222,4227,3668,136,106,240,77
2021,Manchester 055,E02006912,8085,3262,876,766,110,0,2386,2020,366,4823,4255,104,102,233,129
2021,Manchester 056,E02006913,6229,2782,1779,1757,22,7,996,856,140,3447,2731,248,91,226,151
2021,Manchester 057,E02006914,3614,1276,412,366,46,2,862,756,106,2338,2097,59,40,122,20
2021,Manchester 058,E02006915,6275,2818,2196,2170,26,11,611,550,61,3457,2502,228,174,352,201
2021,Manchester 059,E02006916,6288,2422,762,718,44,2,1658,1464,194,3866,3349,83,118,218,98
2021,Manchester 060,E02006917,6023,2420,732,684,48,0,1688,1460,228,3603,3247,127,47,147,35
2021,Manchester 061,E02006983,5817,2490,1160,1100,60,6,1324,1112,212,3327,2586,137,144,293,167
2021,Manchester 062,E02006984,5044,2140,791,749,42,5,1344,1168,176,2904,2531,50,59,181,83
2021,Manchester 063,E02006985,6457,3192,2913,2913,0,7,272,244,28,3265,2269,434,134,249,179
2021,Manchester 064,E02006986,4570,2245,1726,1710,16,4,515,468,47,2325,1594,211,110,262,148
2021,Oldham 001,E02001098,4978,2987,2292,2290,2,4,691,654,37,1991,1097,37,79,324,454
2021,Oldham 002,E02001099,4660,2525,1750,1741,9,9,766,730,36,2135,1261,40,100,414,320
2021,Oldham 003,E02001100,4865,2960,2276,2260,16,0,684,648,36,1905,1129,42,85,316,333
2021,Oldham 004,E02001101,4703,2928,2300,2296,4,0,628,622,6,1775,1024,38,93,282,338
2021,Oldham 005,E02001102,4859,3002,2161,2145,16,3,838,818,20,1857,1155,38,106,297,261
2021,Oldham 006,E02001103,4649,3004,2473,2452,21,4,527,510,17,1645,910,35,67,279,354
2021,Oldham 007,E02001104,5611,3452,2449,2437,12,9,994,948,46,2159,1439,57,111,322,230
2021,Oldham 008,E02001105,4929,2768,2104,2096,8,8,656,644,12,2161,1274,32,87,377,391
2021,Oldham 009,E02001106,4918,2589,1886,1872,14,2,701,672,29,2329,1388,46,104,413,378
2021,Oldham 010,E02001107,5219,3006,2470,2464,6,6,530,500,30,2213,1429,79,113,291,301
2021,Oldham 011,E02001108,4263,2096,1242,1236,6,4,850,814,36,2167,1475,54,121,337,180
2021,Oldham 012,E02001109,5999,2978,2126,2114,12,4,848,818,30,3021,1939,110,148,490,334
2021,Oldham 013,E02001110,5380,3570,2808,2788,20,6,756,726,30,1810,983,41,89,360,337
2021,Oldham 014,E02001111,6309,2594,1934,1925,9,6,654,624,30,3715,2518,180,229,496,292
2021,Oldham 015,E02001112,5004,3296,2670,2656,14,2,624,602,22,1708,1079,39,73,234,283
2021,Oldham 016,E02001113,6692,3213,2930,2926,4,11,272,270,2,3479,2435,303,141,256,344
2021,Oldham 017,E02001114,6822,3646,2837,2829,8,9,800,772,28,3176,2045,101,154,436,440
2021,Oldham 018,E02001115,4792,2696,1899,1893,6,5,792,760,32,2096,1264,54,101,381,296
2021,Oldham 019,E02001116,5415,3071,2636,2632,4,10,425,402,23,2344,1491,249,140,261,203
2021,Oldham 020,E02001117,5007,3192,2634,2622,12,2,556,544,12,1815,1025,34,69,318,369
2021,Oldham 021,E02001118,5037,3242,2525,2517,8,1,716,710,6,1795,1057,42,75,275,346
2021,Oldham 022,E02001119,8441,4366,4083,4083,0,15,268,252,16,4075,2650,558,302,268,297
2021,Oldham 024,E02001121,5995,2867,2537,2531,6,11,319,306,13,3128,2058,381,167,294,228
2021,Oldham 026,E02001123,5173,2629,1848,1832,16,3,778,740,38,2544,1688,71,147,366,272
2021,Oldham 027,E02001124,5267,2497,1721,1715,6,3,773,736,37,2770,1858,105,145,409,253
2021,Oldham 028,E02001125,6323,3520,2528,2514,14,4,988,958,30,2803,1817,59,118,398,411
2021,Oldham 029,E02001126,6608,3204,2309,2293,16,3,892,850,42,3404,2241,197,178,479,309
2021,Oldham 030,E02001127,5755,2862,2044,2032,12,4,814,778,36,2893,2010,60,154,372,297
2021,Oldham 031,E02001128,5975,3088,2174,2168,6,10,904,854,50,2887,1855,59,141,430,402
2021,Oldham 032,E02001129,5347,2672,1617,1600,17,7,1048,980,68,2675,1746,60,126,417,326
2021,Oldham 033,E02001130,4891,2821,2188,2176,12,2,631,608,23,2070,1261,31,81,336,361
2021,Oldham 034,E02001131,4416,2544,1860,1850,10,0,684,660,24,1872,1184,31,70,227,360
2021,Oldham 036,E02007000,5225,2596,2303,2301,2,5,288,268,20,2629,1674,315,143,290,207
2021,Oldham 037,E02007001,6106,3194,2926,2922,4,6,262,250,12,2912,1931,338,134,237,272
2021,Rochdale 001,E02001132,5401,3040,2075,2067,8,9,956,940,16,2361,1387,43,142,448,341
2021,Rochdale 002,E02001133,5271,3503,2534,2525,9,1,968,934,34,1768,1076,30,89,286,287
2021,Rochdale 003,E02001134,5146,3416,2688,2672,16,8,720,702,18,1730,1017,50,103,281,279
2021,Rochdale 004,E02001135,6044,2958,2242,2228,14,10,706,674,32,3086,1949,114,190,509,324
2021,Rochdale 005,E02001136,7266,4260,3316,3298,18,6,938,900,38,3006,1865,109,126,471,435
2021,Rochdale 006,E02001137,5179,3429,2642,2620,22,4,783,756,27,1750,1074,40,93,281,262
2021,Rochdale 007,E02001138,7120,4586,3786,3768,18,0,800,780,20,2534,1451,64,111,431,477
2021,Rochdale 008,E02001139,7508,3767,3217,3213,4,11,539,504,35,3741,2451,346,190,403,351
2021,Rochdale 009,E02001140,6012,3170,2371,2367,4,3,796,764,32,2842,1835,138,141,424,304
2021,Rochdale 010,E02001141,8929,4033,3292,3286,6,13,728,682,46,4896,3118,340,276,697,465
2021,Rochdale 011,E02001142,4973,3147,2716,2710,6,2,429,418,11,1826,1037,88,69,252,380
2021,Rochdale 012,E02001143,8442,4190,3291,3281,10,7,892,854,38,4252,2823,238,222,567,402
2021,Rochdale 013,E02001144,5159,3024,2168,2160,8,2,854,800,54,2135,1298,30,126,387,294
2021,Rochdale 014,E02001145,5762,3513,2615,2602,13,10,888,858,30,2249,1325,31,114,413,366
2021,Rochdale 015,E02001146,7440,3620,3228,3224,4,4,388,370,18,3820,2459,398,184,419,360
2021,Rochdale 016,E02001147,7748,4145,2904,2876,28,10,1231,1184,47,3603,2357,112,190,537,407
2021,Rochdale 017,E02001148,8184,4518,3298,3280,18,2,1218,1160,58,3666,2254,114,190,595,513
2021,Rochdale 018,E02001149,8151,4020,2595,2577,18,13,1412,1368,44,4131,2545,76,235,746,529
2021,Rochdale 019,E02001150,6806,3674,2517,2493,24,9,1148,1100,48,3132,1989,76,164,505,398
2021,Rochdale 020,E02001151,7974,4792,3523,3505,18,6,1263,1224,39,3182,2094,55,158,480,395
2021,Rochdale 021,E02001152,7642,4118,2808,2792,16,8,1302,1260,42,3524,2349,72,184,515,404
2021,Rochdale 022,E02001153,9043,4505,2879,2865,14,13,1613,1533,80,4538,2990,94,261,685,508
2021,Rochdale 023,E02001154,8029,4300,2866,2854,12,8,1426,1382,44,3729,2431,60,202,598,438
2021,Rochdale 024,E02001155,5804,2916,1953,1935,18,11,952,908,44,2888,1746,67,180,511,384
2021,Rochdale 025,E02001156,8036,4974,3974,3947,27,3,997,971,26,3062,1911,68,117,412,554
2021,Salford 001,E02001157,6297,2746,1657,1640,17,6,1083,1046,37,3551,2427,76,199,526,323
2021,Salford 002,E02001158,4721,2284,1479,1469,10,3,802,760,42,2437,1633,47,99,384,274
2021,Salford 003,E02001159,5843,3276,1956,1916,40,6,1314,1252,62,2567,1697,61,145,408,256
2021,Salford 004,E02001160,5367,2902,2014,1984,30,0,888,850,38,2465,1679,35,110,359,282
2021,Salford 005,E02001161,4864,2710,1978,1966,12,2,730,694,36,2154,1399,50,78,345,282
2021,Salford 006,E02001162,4825,2553,1766,1757,9,5,782,762,20,2272,1442,42,102,360,326
2021,Salford 007,E02001163,8114,4914,3399,3361,38,7,1508,1424,84,3200,2059,44,116,509,472
2021,Salford 008,E02001164,5136,2708,1696,1674,22,2,1010,952,58,2428,1701,62,143,313,209
2021,Salford 009,E02001165,4962,2767,1820,1789,31,1,946,918,28,2195,1448,32,71,343,301
2021,Salford 010,E02001166,5334,3024,2744,2724,20,0,280,252,28,2310,1608,208,60,227,207
2021,Salford 011,E02001167,5274,2738,2058,2044,14,6,674,622,52,2536,1733,117,109,318,259
2021,Salford 012,E02001168,7759,4246,2909,2887,22,1,1336,1274,62,3513,2288,68,162,535,460
2021,Salford 013,E02001169,8878,5942,4701,4675,26,3,1238,1198,40,2936,1820,61,101,461,493
2021,Salford 014,E02001170,7927,5329,4242,4204,38,0,1087,1024,63,2598,1474,49,110,412,553
2021,Salford 015,E02001171,5052,3174,2324,2310,14,8,842,802,40,1878,1203,48,74,251,302
2021,Salford 017,E02001173,6871,2488,1467,1431,36,1,1020,946,74,4383,3393,121,194,404,271
2021,Salford 018,E02001174,4753,2576,1703,1683,20,5,868,774,94,2177,1553,52,88,227,257
2021,Salford 019,E02001175,5931,3193,1991,1967,24,8,1194,1140,54,2738,1903,52,110,352,321
2021,Salford 020,E02001176,9726,5151,3446,3391,55,13,1692,1550,142,4575,2837,133,188,779,638
2021,Salford 021,E02001177,10704,5196,3188,3142,46,22,1986,1787,199,5508,3895,155,225,707,526
2021,Salford 023,E02001179,5837,2406,1359,1329,30,1,1046,938,108,3431,2522,129,141,337,302
2021,Salford 024,E02001180,4148,1576,941,931,10,5,630,564,66,2572,1784,65,129,398,196
2021,Salford 025,E02001181,4662,2143,1355,1341,14,3,785,726,59,2519,1687,50,123,430,229
2021,Salford 026,E02001182,5711,2746,1617,1581,36,5,1124,1040,84,2965,2042,85,140,464,234
2021,Salford 027,E02001183,5828,2864,1657,1651,6,7,1200,1128,72,2964,2121,69,145,384,245
2021,Salford 029,E02001185,7712,4338,3103,3089,14,3,1232,1198,34,3374,2084,50,158,561,521
2021,Salford 030,E02001186,8265,4636,3139,3121,18,5,1492,1432,60,3629,2348,56,149,627,449
2021,Salford 031,E02006957,5005,2350,1995,1991,4,7,348,310,38,2655,1911,159,116,314,155
2021,Salford 032,E02006958,6002,2528,1608,1578,30,12,908,780,128,3474,2661,151,135,313,214
2021,Salford 033,E02006959,7460,2855,869,819,50,0,1986,1716,270,4605,4149,112,96,193,55
2021,Salford 034,E02006960,6555,2773,1138,1102,36,0,1635,1395,240,3782,3177,95,128,261,121
2021,Salford 035,E02006961,5382,2211,1008,980,28,5,1198,1078,120,3171,2483,111,147,273,157
2021,Salford 036,E02006962,4645,1701,659,637,22,0,1042,920,122,2944,2657,47,53,116,71
2021,Salford 037,E02006963,5696,2726,1028,970,58,0,1698,1486,212,2970,2574,122,52,181,41
2021,Stockport 001,E02001187,5698,3150,2187,2167,20,3,960,908,52,2548,1656,33,94,387,378
2021,Stockport 002,E02001188,6818,3451,2055,2043,12,11,1385,1174,211,3367,2382,67,152,476,290
2021,Stockport 003,E02001189,6787,4049,2906,2888,18,8,1135,1078,57,2738,1758,47,129,424,380
2021,Stockport 004,E02001190,5791,2490,1427,1415,12,3,1060,978,82,3301,2468,39,133,412,249
2021,Stockport 005,E02001191,4837,2970,2302,2286,16,4,664,634,30,1867,1117,33,68,323,326
2021,Stockport 006,E02001192,5346,3268,2428,2388,40,6,834,782,52,2078,1337,50,101,259,331
2021,Stockport 007,E02001193,5231,2749,1659,1634,25,2,1088,1032,56,2482,1684,40,92,422,244
2021,Stockport 008,E02001194,5074,3243,2624,2592,32,9,610,588,22,1831,1145,54,57,269,306
2021,Stockport 009,E02001195,6100,3688,2562,2538,24,4,1122,1082,40,2412,1478,43,113,387,391
2021,Stockport 010,E02001196,6427,3999,3096,3086,10,6,897,869,28,2428,1421,34,107,396,470
2021,Stockport 011,E02001197,5000,3070,2432,2406,26,8,630,582,48,1930,1214,46,70,356,244
2021,Stockport 012,E02001198,5979,3288,2392,2370,22,10,886,846,40,2691,1598,32,112,434,515
2021,Stockport 013,E02001199,6454,4004,3114,3074,40,6,884,828,56,2450,1496,83,116,388,367
2021,Stockport 014,E02001200,6255,2523,1450,1422,28,5,1068,994,74,3732,2515,100,163,697,257
2021,Stockport 015,E02001201,4630,2770,1884,1870,14,2,884,846,38,1860,1179,34,81,298,268
2021,Stockport 016,E02001202,5264,2587,1444,1404,40,8,1135,1070,65,2677,1842,59,125,443,208
2021,Stockport 017,E02001203,4826,3502,3008,2980,28,6,488,466,22,1324,739,30,40,218,297
2021,Stockport 018,E02001204,7087,4287,2913,2875,38,6,1368,1288,80,2800,1855,50,116,444,335
2021,Stockport 019,E02001205,6887,3675,2441,2418,23,14,1220,1164,56,3212,2172,57,127,558,298
2021,Stockport 020,E02001206,5811,3692,2904,2896,8,6,782,752,30,2119,1174,46,100,373,426
2021,Stockport 021,E02001207,5642,3634,2854,2850,4,6,774,736,38,2008,1170,25,96,340,377
2021,Stockport 022,E02001208,6132,3500,2383,2341,42,9,1108,1062,46,2632,1664,51,105,452,360
2021,Stockport 023,E02001209,6167,3513,2305,2273,32,7,1201,1130,71,2654,1770,36,117,469,262
2021,Stockport 024,E02001210,5773,3062,2202,2190,12,2,858,824,34,2711,1698,37,122,486,368
2021,Stockport 025,E02001211,5196,3400,2860,2842,18,0,540,510,30,1796,1035,60,94,292,315
2021,Stockport 026,E02001212,5138,2592,1747,1723,24,5,840,802,38,2546,1775,44,125,389,213
2021,Stockport 027,E02001213,7919,4838,3577,3547,30,3,1258,1218,40,3081,1821,76,135,599,450
2021,Stockport 028,E02001214,6486,3944,3389,3383,6,9,546,508,38,2542,1497,92,105,354,494
2021,Stockport 029,E02001215,4894,3158,2502,2494,8,4,652,626,26,1736,923,31,78,311,393
2021,Stockport 030,E02001216,6353,4072,3370,3348,22,2,700,664,36,2281,1345,50,86,300,500
2021,Stockport 031,E02001217,5482,3044,2132,2116,16,0,912,866,46,2438,1379,53,114,487,405
2021,Stockport 032,E02001218,4796,3265,2796,2784,12,10,459,446,13,1531,914,35,58,235,289
2021,Stockport 033,E02001219,4402,2956,2422,2412,10,4,530,518,12,1446,793,27,42,252,332
2021,Stockport 034,E02001220,4525,2874,2364,2342,22,1,509,488,21,1651,943,38,69,328,273
2021,Stockport 035,E02001221,4835,3321,2795,2785,10,8,518,502,16,1514,910,22,52,193,337
2021,Stockport 036,E02001222,5179,3286,2822,2816,6,0,464,440,24,1893,1085,110,44,246,408
2021,Stockport 037,E02001223,5441,3640,3126,3114,12,0,514,492,22,1801,962,56,60,324,399
2021,Stockport 038,E02001224,4948,3394,2888,2866,22,2,504,492,12,1554,835,35,48,217,419
2021,Stockport 039,E02001225,5914,3854,3205,3189,16,3,646,608,38,2060,1164,40,78,358,420
2021,Stockport 040,E02001226,5621,3413,2789,2774,15,12,612,588,24,2208,1334,96,93,300,385
2021,Stockport 041,E02001227,4580,3196,2848,2844,4,2,346,340,6,1384,719,27,39,217,382
2021,Stockport 042,E02001228,5048,3583,3088,3072,16,2,493,477,16,1465,826,33,45,203,358
2021,Tameside 001,E02001229,8345,5028,3398,3366,32,0,1630,1558,72,3317,2013,46,151,650,457
2021,Tameside 002,E02001230,4887,3066,2595,2563,32,7,464,454,10,1821,1119,61,74,229,338
2021,Tameside 003,E02001231,5575,3442,2539,2517,22,9,894,874,20,2133,1396,29,101,310,297
2021,Tameside 004,E02001232,6694,3620,2579,2561,18,7,1034,980,54,3074,1993,96,130,470,385
2021,Tameside 005,E02001233,6242,3362,2485,2475,10,5,872,846,26,2880,1663,91,155,478,493
2021,Tameside 006,E02001234,6014,3053,2144,2122,22,4,905,870,35,2961,1918,106,141,465,331
2021,Tameside 007,E02001235,5691,3280,2278,2240,38,4,998,952,46,2411,1504,91,117,408,291
2021,Tameside 008,E02001236,4589,2234,1432,1406,26,2,800,768,32,2355,1501,53,162,352,287
2021,Tameside 009,E02001237,5644,3203,2175,2162,13,6,1022,988,34,2441,1543,49,128,456,265
2021,Tameside 010,E02001238,6544,3638,2603,2591,12,3,1032,992,40,2906,1788,70,131,465,452
2021,Tameside 011,E02001239,7562,4182,2822,2772,50,2,1358,1296,62,3380,2219,62,166,504,429
2021,Tameside 012,E02001240,5187,2910,2031,2017,14,5,874,830,44,2277,1486,57,110,336,288
2021,Tameside 013,E02001241,8410,3599,2675,2660,15,8,916,876,40,4811,3106,309,261,702,433
2021,Tameside 014,E02001242,5652,3554,2639,2623,16,5,910,884,26,2098,1322,59,83,264,370
2021,Tameside 015,E02001243,6932,4162,3112,3089,23,8,1042,1002,40,2770,1650,34,161,530,395
2021,Tameside 016,E02001244,4485,2864,2144,2132,12,8,712,688,24,1621,967,25,74,230,325
2021,Tameside 017,E02001245,6397,3466,2316,2300,16,4,1146,1086,60,2931,1889,41,148,499,354
2021,Tameside 018,E02001246,5839,3171,2126,2112,14,9,1036,997,39,2668,1666,40,118,460,384
2021,Tameside 019,E02001247,5944,3258,2156,2142,14,6,1096,1057,39,2686,1671,54,130,506,325
2021,Tameside 020,E02001248,9323,5028,3179,3133,46,9,1840,1762,78,4295,2746,74,264,721,490
2021,Tameside 021,E02001249,5184,2754,1879,1861,18,5,870,834,36,2430,1558,42,115,397,318
2021,Tameside 022,E02001250,5380,3463,2596,2570,26,0,867,846,21,1917,1199,28,69,315,306
2021,Tameside 023,E02001251,5096,3060,2206,2180,26,0,854,822,32,2036,1203,34,110,353,336
2021,Tameside 024,E02001252,6303,3870,2918,2894,24,8,944,910,34,2433,1421,48,98,358,508
2021,Tameside 025,E02001253,4114,2308,1677,1665,12,5,626,600,26,1806,1117,48,83,312,246
2021,Tameside 026,E02001254,4596,2532,1752,1746,6,0,780,754,26,2064,1247,24,110,342,341
2021,Tameside 027,E02001255,5667,2800,1688,1666,22,10,1102,1038,64,2867,1915,41,140,446,325
2021,Tameside 028,E02001256,7969,4125,3017,3000,17,14,1094,1020,74,3844,2519,158,195,523,449
2021,Tameside 029,E02001257,7436,3841,2671,2651,20,10,1160,1116,44,3595,2040,86,196,580,693
2021,Tameside 030,E02001258,6093,3827,2870,2852,18,4,953,890,63,2266,1309,43,91,390,433
2021,Trafford 001,E02001259,9157,3893,2708,2661,47,9,1176,1082,94,5264,3890,231,233,556,354
2021,Trafford 002,E02001260,6137,3914,3134,3116,18,4,776,742,34,2223,1392,36,77,368,350
2021,Trafford 003,E02001261,6915,3596,2374,2354,20,12,1210,1110,100,3319,2395,89,140,416,279
2021,Trafford 004,E02001262,6838,3481,2787,2737,50,6,688,620,68,3357,2343,173,121,362,358
2021,Trafford 005,E02001263,6749,4460,3649,3635,14,1,810,790,20,2289,1343,49,78,355,464
2021,Trafford 006,E02001264,6735,4020,3101,3071,30,5,914,866,48,2715,1822,68,94,381,350
2021,Trafford 007,E02001265,6589,3950,3016,2994,22,12,922,894,28,2639,1607,42,109,495,386
2021,Trafford 008,E02001266,5562,2862,2193,2175,18,7,662,626,36,2700,1763,55,128,455,299
2021,Trafford 009,E02001267,5928,3362,2419,2389,30,13,930,876,54,2566,1514,41,116,471,424
2021,Trafford 010,E02001268,5733,3746,3040,3016,24,12,694,658,36,1987,1160,38,65,322,402
2021,Trafford 011,E02001269,6702,3570,2565,2519,46,3,1002,950,52,3132,2063,82,150,443,394
2021,Trafford 012,E02001270,6626,4133,3061,3044,17,2,1070,1016,54,2493,1530,67,109,432,355
2021,Trafford 013,E02001271,5219,3014,2271,2250,21,12,731,707,24,2205,1325,35,92,419,334
2021,Trafford 014,E02001272,6334,4108,3296,3266,30,2,810,778,32,2226,1299,37,122,380,388
2021,Trafford 015,E02001273,7523,4654,3573,3543,30,3,1078,1006,72,2869,1706,77,128,567,391
2021,Trafford 016,E02001274,6418,4326,3885,3861,24,1,440,418,22,2092,1277,44,73,261,437
2021,Trafford 017,E02001275,6142,2992,2023,2009,14,13,956,928,28,3150,2042,45,154,502,407
2021,Trafford 018,E02001276,6228,3602,2724,2706,18,4,874,834,40,2626,1618,52,122,454,380
2021,Trafford 019,E02001277,7073,3753,2788,2769,19,7,958,912,46,3320,2231,72,161,560,296
2021,Trafford 020,E02001278,6687,4520,3837,3819,18,5,678,654,24,2167,1364,64,71,327,341
2021,Trafford 021,E02001279,6501,4568,3966,3946,20,6,596,576,20,1933,1224,49,54,277,329
2021,Trafford 022,E02001280,6549,3498,2776,2770,6,0,722,714,8,3051,1826,74,123,546,482
2021,Trafford 023,E02001281,6177,4230,3659,3639,20,5,566,548,18,1947,1121,26,57,308,435
2021,Trafford 024,E02001282,7781,4973,3599,3567,32,5,1369,1336,33,2808,1774,68,101,511,354
2021,Trafford 025,E02001283,7592,4901,3890,3864,26,8,1003,936,67,2691,1621,77,123,450,420
2021,Trafford 026,E02001284,6265,4294,3658,3618,40,12,624,594,30,1971,1227,45,76,326,297
2021,Trafford 027,E02001285,6200,3996,3328,3314,14,4,664,628,36,2204,1277,56,87,390,394
2021,Trafford 028,E02001286,6408,4206,3855,3845,10,6,345,326,19,2202,1279,108,76,292,447
2021,Wigan 001,E02001287,5435,3691,2701,2672,29,2,988,966,22,1744,1075,24,63,292,290
2021,Wigan 002,E02001288,6907,4509,3518,3498,20,6,985,951,34,2398,1415,37,103,394,449
2021,Wigan 003,E02001289,8492,5596,4507,4489,18,3,1086,1050,36,2896,1539,55,122,525,655
2021,Wigan 004,E02001290,5092,3177,2494,2476,18,1,682,646,36,1915,1142,25,79,306,363
2021,Wigan 005,E02001291,6322,3706,2653,2637,16,3,1050,1012,38,2616,1634,49,124,423,386
2021,Wigan 006,E02001292,6731,4136,3164,3150,14,0,972,928,44,2595,1553,87,121,392,442
2021,Wigan 007,E02001293,5173,3323,2518,2507,11,3,802,772,30,1850,1126,34,72,286,332
2021,Wigan 008,E02001294,6582,3663,2439,2424,15,2,1222,1134,88,2919,1860,74,154,464,367
2021,Wigan 009,E02001295,5835,2666,1707,1692,15,3,956,906,50,3169,1890,66,164,673,376
2021,Wigan 010,E02001296,6561,3164,1831,1821,10,1,1332,1286,46,3397,2282,64,157,559,335
2021,Wigan 011,E02001297,5366,3094,2172,2156,16,2,920,880,40,2272,1395,31,108,384,354
2021,Wigan 012,E02001298,6302,3292,2141,2133,8,11,1140,1110,30,3010,1963,51,138,501,357
2021,Wigan 013,E02001299,7136,4185,3010,2990,20,5,1170,1106,64,2951,1855,41,146,452,457
2021,Wigan 014,E02001300,6378,3652,2432,2418,14,8,1212,1168,44,2726,1631,54,136,467,438
2021,Wigan 015,E02001301,7114,3806,2335,2321,14,5,1466,1392,74,3308,2048,78,168,593,421
2021,Wigan 016,E02001302,6314,3642,2584,2582,2,2,1056,1024,32,2672,1647,37,119,404,465
2021,Wigan 017,E02001303,6936,3660,2370,2340,30,6,1284,1218,66,3276,2150,52,195,515,364
2021,Wigan 018,E02001304,10560,6830,5360,5333,27,12,1458,1402,56,3730,2113,52,167,625,773
2021,Wigan 019,E02001305,7065,4617,3498,3474,24,4,1115,1069,46,2448,1459,48,71,394,476
2021,Wigan 020,E02001306,6000,3846,3026,3014,12,0,820,798,22,2154,1313,35,83,355,368
2021,Wigan 021,E02001307,9499,6576,5314,5304,10,0,1262,1214,48,2923,1807,44,122,453,497
2021,Wigan 022,E02001308,4940,2958,2146,2142,4,8,804,768,36,1982,1164,32,87,365,334
2021,Wigan 023,E02001309,6796,4013,2656,2642,14,6,1351,1290,61,2783,1617,47,143,549,427
2021,Wigan 024,E02001310,7182,4046,2721,2699,22,5,1320,1250,70,3136,2041,61,132,517,385
2021,Wigan 025,E02001311,6728,3898,2737,2725,12,3,1158,1108,50,2830,1721,47,129,535,398
2021,Wigan 026,E02001312,6503,3973,2706,2682,24,3,1264,1204,60,2530,1636,41,129,395,329
2021,Wigan 027,E02001313,6396,3555,2451,2427,24,12,1092,1044,48,2841,1784,49,140,484,384
2021,Wigan 028,E02001314,6331,4111,3231,3219,12,5,875,856,19,2220,1403,24,95,379,319
2021,Wigan 029,E02001315,7683,5121,3615,3586,29,5,1501,1442,59,2562,1538,53,110,432,429
2021,Wigan 030,E02001316,5897,2952,1718,1702,16,2,1232,1158,74,2945,1879,90,182,510,284
2021,Wigan 031,E02001317,7188,4326,3009,2999,10,3,1314,1270,44,2862,1822,51,166,449,374
2021,Wigan 032,E02001318,6495,3812,2840,2834,6,6,966,936,30,2683,1621,39,111,425,487
2021,Wigan 033,E02001319,6614,3647,2287,2275,12,5,1355,1298,57,2967,1820,45,144,545,413
2021,Wigan 034,E02001320,6070,3390,2352,2340,12,4,1034,994,40,2680,1614,35,106,500,425
2021,Wigan 035,E02001321,6536,4130,3193,3167,26,5,932,890,42,2406,1442,33,123,396,412
2021,Wigan 036,E02001322,5967,3687,2808,2800,8,3,876,844,32,2280,1298,25,112,425,420
2021,Wigan 037,E02001323,6342,3820,2876,2864,12,0,944,902,42,2522,1449,47,114,465,447
2021,Wigan 038,E02001324,6641,3823,2615,2595,20,5,1203,1142,61,2818,1721,47,128,484,438
2021,Wigan 039,E02001325,7416,4905,3679,3654,25,4,1222,1170,52,2511,1464,50,115,438,444
2021,Wigan 040,E02001326,6698,4314,3237,3219,18,1,1076,1024,52,2384,1409,34,97,402,442
2021,Birmingham 001,E02001827,5141,3208,2746,2740,6,4,458,452,6,1933,1115,47,70,330,371
2021,Birmingham 002,E02001828,5819,3590,3012,3002,10,2,576,542,34,2229,1267,47,95,354,466
2021,Birmingham 003,E02001829,7134,4816,4135,4117,18,3,678,670,8,2318,1379,59,67,366,447
2021,Birmingham 004,E02001830,8027,5411,4664,4646,18,9,738,712,26,2616,1604,85,87,323,517
2021,Birmingham 005,E02001831,8296,4413,3347,3327,20,14,1052,1012,40,3883,2445,77,178,688,495
2021,Birmingham 006,E02001832,6575,4170,3443,3421,22,5,722,682,40,2405,1460,56,87,368,434
2021,Birmingham 007,E02001833,4810,2998,2484,2478,6,4,510,486,24,1812,1206,38,68,220,280
2021,Birmingham 008,E02001834,4647,2296,1610,1604,6,0,686,664,22,2351,1587,53,118,337,256
2021,Birmingham 009,E02001835,6713,4060,3100,3080,20,2,958,914,44,2653,1645,60,100,463,385
2021,Birmingham 010,E02001836,7389,4798,4001,3961,40,9,788,746,42,2591,1581,62,117,362,469
2021,Birmingham 011,E02001837,7977,3462,2430,2426,4,1,1031,970,61,4515,3166,106,245,596,402
2021,Birmingham 012,E02001838,6269,4140,3414,3402,12,6,720,686,34,2129,1258,55,76,327,413
2021,Birmingham 013,E02001839,5155,2672,1959,1951,8,9,704,684,20,2483,1573,63,109,354,384
2021,Birmingham 014,E02001840,7181,3082,2211,2203,8,13,858,830,28,4099,2832,109,206,582,370
2021,Birmingham 015,E02001841,4905,3276,2894,2880,14,4,378,362,16,1629,987,51,65,195,331
2021,Birmingham 016,E02001842,6414,3474,2778,2770,8,10,686,658,28,2940,1931,115,138,372,384
2021,Birmingham 017,E02001843,5293,2833,2054,2036,18,9,770,740,30,2460,1631,74,93,323,339
2021,Birmingham 018,E02001844,7829,4246,3262,3222,40,12,972,906,66,3583,2138,79,158,629,579
2021,Birmingham 019,E02001845,5193,2826,2066,2054,12,4,756,732,24,2367,1569,59,99,378,262
2021,Birmingham 020,E02001846,6279,2944,2042,2024,18,4,898,842,56,3335,2218,107,177,487,346
2021,Birmingham 021,E02001847,4565,2841,2290,2282,8,7,544,526,18,1724,1056,35,54,288,291
2021,Birmingham 022,E02001848,5236,2349,1772,1766,6,12,565,537,28,2887,2064,108,133,327,255
2021,Birmingham 023,E02001849,6472,2853,1790,1772,18,10,1053,992,61,3619,2552,95,190,536,246
2021,Birmingham 024,E02001850,6622,3366,2833,2824,9,6,527,515,12,3256,2218,181,144,339,374
2021,Birmingham 025,E02001851,7160,3654,2668,2632,36,6,980,952,28,3506,2322,78,174,516,416
2021,Birmingham 026,E02001852,5565,2475,1870,1858,12,11,594,554,40,3090,2095,158,138,376,323
2021,Birmingham 029,E02001855,7611,3106,2066,2060,6,8,1032,974,58,4505,3103,72,209,621,500
2021,Birmingham 030,E02001856,7296,3232,2489,2445,44,9,734,702,32,4064,2946,197,200,444,277
2021,Birmingham 031,E02001857,10720,4210,2982,2962,20,18,1210,1116,94,6510,4683,280,327,825,395
2021,Birmingham 032,E02001858,6570,2687,2281,2279,2,12,394,366,28,3883,2644,241,202,487,309
2021,Birmingham 033,E02001859,7564,3478,3174,3168,6,4,300,286,14,4086,2801,345,214,377,349
2021,Birmingham 034,E02001860,6336,2809,2423,2423,0,9,377,352,25,3527,2332,336,166,371,322
2021,Birmingham 035,E02001861,8251,3336,2975,2975,0,11,350,326,24,4915,3518,395,217,445,340
2021,Birmingham 036,E02001862,7423,3291,2862,2860,2,13,416,380,36,4132,2768,283,250,447,384
2021,Birmingham 037,E02001863,6085,2538,2319,2317,2,3,216,208,8,3547,2473,288,171,318,297
2021,Birmingham 039,E02001865,8590,3638,3289,3285,4,17,332,300,32,4952,3329,494,247,440,442
2021,Birmingham 040,E02001866,7075,2816,2567,2560,7,3,246,231,15,4259,2987,372,202,349,349
2021,Birmingham 041,E02001867,6190,2402,2198,2194,4,10,194,190,4,3788,2691,282,202,314,299
2021,Birmingham 042,E02001868,7195,3761,3410,3403,7,9,342,318,24,3434,2461,286,131,232,324
2021,Birmingham 043,E02001869,4649,1602,1303,1303,0,9,290,266,24,3047,2107,199,202,344,195
2021,Birmingham 044,E02001870,9061,4423,4010,4006,4,25,388,368,20,4638,3207,392,249,397,393
2021,Birmingham 045,E02001871,6331,2902,2026,2012,14,4,872,833,39,3429,2255,91,172,473,438
2021,Birmingham 046,E02001872,5593,2582,1669,1657,12,3,910,864,46,3011,2088,45,122,416,340
2021,Birmingham 047,E02001873,8282,3076,2500,2490,10,8,568,520,48,5206,3661,360,339,515,331
2021,Birmingham 048,E02001874,7007,3112,2823,2823,0,5,284,280,4,3895,2645,403,230,301,316
2021,Birmingham 049,E02001875,6452,2540,1825,1805,20,17,698,644,54,3912,2887,214,233,343,235
2021,Birmingham 050,E02001876,6547,2222,1577,1569,8,3,642,598,44,4325,3301,250,201,379,194
2021,Birmingham 051,E02001877,8641,3794,3552,3548,4,14,228,226,2,4847,3329,498,263,369,388
2021,Birmingham 052,E02001878,6749,2853,2574,2564,10,10,269,258,11,3896,2671,356,201,373,295
2021,Birmingham 053,E02001879,7050,2756,2354,2342,12,4,398,354,44,4294,3096,333,181,385,299
2021,Birmingham 054,E02001880,7079,3120,2299,2295,4,3,818,780,38,3959,2818,109,203,490,339
2021,Birmingham 055,E02001881,7288,3376,3044,3042,2,6,326,316,10,3912,2728,327,222,325,310
2021,Birmingham 056,E02001882,6598,3022,2540,2526,14,12,470,452,18,3576,2423,216,165,414,358
2021,Birmingham 057,E02001883,6390,2750,1897,1875,22,13,840,788,52,3640,2497,84,181,495,383
2021,Birmingham 058,E02001884,6875,3246,3023,3019,4,9,214,214,0,3629,2537,360,189,261,282
2021,Birmingham 060,E02001886,7797,3566,2940,2918,22,10,616,536,80,4231,3115,290,176,365,285
2021,Birmingham 062,E02001888,5245,2451,1892,1883,9,7,552,526,26,2794,1919,96,126,329,324
2021,Birmingham 063,E02001889,6258,3006,2852,2848,4,4,150,134,16,3252,2289,329,158,220,256
2021,Birmingham 064,E02001890,8035,3512,2634,2582,52,10,868,804,64,4523,3344,245,166,464,304
2021,Birmingham 066,E02001892,7955,3822,3357,3353,4,11,454,432,22,4133,2868,295,210,413,347
2021,Birmingham 067,E02001893,6808,3518,2951,2941,10,9,558,530,28,3290,2166,150,119,453,402
2021,Birmingham 069,E02001895,6794,3103,2226,2214,12,11,866,826,40,3691,2520,84,164,508,415
2021,Birmingham 070,E02001896,7210,3278,3083,3083,0,9,186,170,16,3932,2579,502,199,271,381
2021,Birmingham 071,E02001897,6106,2388,2096,2086,10,14,278,268,10,3718,2531,274,248,397,268
2021,Birmingham 072,E02001898,5329,3128,2444,2432,12,8,676,656,20,2201,1418,61,93,296,333
2021,Birmingham 073,E02001899,6901,4145,3525,3490,35,10,610,562,48,2756,1632,143,104,371,506
2021,Birmingham 074,E02001900,5118,2146,1774,1746,28,6,366,328,38,2972,2024,167,142,406,233
2021,Birmingham 075,E02001901,6713,3745,2646,2594,52,5,1094,992,102,2968,2095,82,104,398,289
2021,Birmingham 076,E02001902,4879,2750,2074,2068,6,6,670,650,20,2129,1434,60,90,270,275
2021,Birmingham 077,E02001903,5833,2514,2400,2392,8,8,106,98,8,3319,2120,380,186,316,317
2021,Birmingham 078,E02001904,5507,2610,2160,2153,7,8,442,412,30,2897,1980,188,138,328,263
2021,Birmingham 079,E02001905,5198,2792,2221,2187,34,3,568,516,52,2406,1728,130,60,242,246
2021,Birmingham 080,E02001906,7664,4186,3270,3250,20,12,904,862,42,3478,2350,74,143,493,418
2021,Birmingham 081,E02001907,8414,4590,3397,3381,16,3,1190,1132,58,3824,2461,116,166,557,524
2021,Birmingham 082,E02001908,6512,2992,2805,2793,12,12,175,171,4,3520,2337,422,185,248,328
2021,Birmingham 083,E02001909,5975,2578,2350,2344,6,6,222,212,10,3397,2362,337,169,292,237
2021,Birmingham 084,E02001910,5430,2124,1857,1853,4,7,260,244,16,3306,2261,296,166,303,280
2021,Birmingham 085,E02001911,6377,2790,2121,2109,12,3,666,616,50,3587,2488,89,196,503,311
2021,Birmingham 087,E02001913,5986,2366,1690,1672,18,2,674,624,50,3620,2727,133,107,382,271
2021,Birmingham 088,E02001914,5410,2712,2213,2185,28,3,496,462,34,2698,1837,204,114,243,300
2021,Birmingham 089,E02001915,9373,4491,3402,3359,43,9,1080,1010,70,4882,3265,191,211,718,497
2021,Birmingham 090,E02001916,7172,3512,2960,2952,8,10,542,506,36,3660,2562,180,195,415,308
2021,Birmingham 092,E02001918,6937,3123,2232,2186,46,9,882,810,72,3814,2701,179,142,510,282
2021,Birmingham 093,E02001919,5581,2495,2069,2051,18,4,422,392,30,3086,2125,249,115,324,273
2021,Birmingham 094,E02001920,5925,2723,2060,2048,12,3,660,636,24,3202,2232,66,142,442,320
2021,Birmingham 095,E02001921,6017,3064,2245,2225,20,9,810,762,48,2953,2032,77,130,410,304
2021,Birmingham 096,E02001922,12771,1269,718,702,16,2,549,500,49,11502,11035,109,87,156,115
2021,Birmingham 097,E02001923,8423,4162,3774,3768,6,12,376,350,26,4261,2809,389,164,398,501
2021,Birmingham 098,E02001924,5433,2832,2424,2414,10,8,400,390,10,2601,1728,117,135,359,262
2021,Birmingham 099,E02001925,5374,2745,2110,2094,16,3,632,582,50,2629,1811,77,94,326,321
2021,Birmingham 100,E02001926,6194,2942,2128,2088,40,2,812,740,72,3252,2435,114,100,328,275
2021,Birmingham 101,E02001927,5696,2657,1974,1970,4,0,683,648,35,3039,2100,58,153,421,307
2021,Birmingham 102,E02001928,5317,2533,1880,1864,16,5,648,630,18,2784,1841,46,135,461,301
2021,Birmingham 103,E02001929,7480,3481,2677,2667,10,14,790,762,28,3999,2794,154,226,471,354
2021,Birmingham 104,E02001930,6231,3494,2462,2410,52,8,1024,922,102,2737,1865,90,104,405,273
2021,Birmingham 105,E02001931,6834,3712,3205,3195,10,5,502,482,20,3122,1996,195,143,384,404
2021,Birmingham 106,E02001932,5454,2550,1803,1789,14,9,738,690,48,2904,1978,53,146,434,293
2021,Birmingham 107,E02001933,5993,2978,2134,2106,28,6,838,798,40,3015,2078,67,149,428,293
2021,Birmingham 108,E02001934,5519,3036,2685,2681,4,5,346,338,8,2483,1707,122,83,244,327
2021,Birmingham 109,E02001935,6312,3420,2738,2708,30,6,676,646,30,2892,1844,67,144,398,439
2021,Birmingham 110,E02001936,5075,3056,2612,2576,36,2,442,420,22,2019,1300,58,65,268,328
2021,Birmingham 111,E02001937,6303,2956,2350,2332,18,2,604,574,30,3347,2321,104,155,430,337
2021,Birmingham 112,E02001938,6378,3463,2245,2209,36,9,1209,1100,109,2915,2075,65,110,406,259
2021,Birmingham 113,E02001939,5109,2522,2051,2043,8,3,468,452,16,2587,1581,54,122,422,408
2021,Birmingham 115,E02001941,4785,2235,1618,1608,10,14,603,574,29,2550,1694,72,142,380,262
2021,Birmingham 116,E02001942,5357,2712,1984,1958,26,6,722,666,56,2645,1742,52,130,418,303
2021,Birmingham 117,E02001943,5091,2618,1921,1899,22,5,692,658,34,2473,1657,71,100,362,283
2021,Birmingham 118,E02001944,6409,3394,2437,2407,30,3,954,916,38,3015,2022,63,115,488,327
2021,Birmingham 119,E02001945,5896,2640,1797,1787,10,13,830,782,48,3256,2299,70,142,499,246
2021,Birmingham 120,E02001946,6139,3656,2850,2830,20,6,800,764,36,2483,1559,50,109,392,373
2021,Birmingham 121,E02001947,4600,1808,1254,1250,4,6,548,520,28,2792,1905,60,127,422,278
2021,Birmingham 122,E02001948,5828,3238,2269,2251,18,9,960,940,20,2590,1652,66,157,362,353
2021,Birmingham 123,E02001949,4664,2373,1572,1560,12,3,798,764,34,2291,1519,57,106,376,233
2021,Birmingham 124,E02001950,6936,3952,2894,2872,22,2,1056,1006,50,2984,1909,42,147,431,455
2021,Birmingham 125,E02001951,7084,3144,2074,2050,24,8,1062,1038,24,3940,2731,59,176,609,365
2021,Birmingham 126,E02001952,6943,2862,1898,1878,20,14,950,908,42,4081,2704,96,199,701,381
2021,Birmingham 127,E02001953,5657,3304,2570,2540,30,4,730,700,30,2353,1523,56,84,335,355
2021,Birmingham 128,E02001954,5683,2456,1632,1625,7,6,818,782,36,3227,2146,67,163,551,300
2021,Birmingham 129,E02001955,6240,3154,2001,1979,22,7,1146,1096,50,3086,1976,58,150,523,379
2021,Birmingham 130,E02001956,5336,2943,2055,2033,22,14,874,856,18,2393,1592,21,115,389,276
2021,Birmingham 131,E02001957,6275,3627,2550,2538,12,6,1071,1047,24,2648,1742,54,91,407,354
2021,Birmingham 132,E02006807,6420,3832,3263,3249,14,7,562,534,28,2588,1706,105,108,305,364
2021,Birmingham 133,E02006809,8142,4369,4050,4048,2,11,308,296,12,3773,2495,286,139,366,487
2021,Birmingham 134,E02006895,6764,2575,1527,1510,17,2,1046,956,90,4189,3369,186,146,354,134
2021,Birmingham 135,E02006896,4903,1922,941,913,28,3,978,882,96,2981,2426,147,101,216,91
2021,Birmingham 136,E02006897,6395,2257,1268,1254,14,5,984,896,88,4138,3337,148,190,336,127
2021,Birmingham 137,E02006898,6926,2940,1252,1216,36,8,1680,1524,156,3986,3265,170,142,315,94
2021,Birmingham 138,E02006899,5828,2327,875,843,32,0,1452,1322,130,3501,2976,138,112,224,51
2021,Birmingham 139,E02006900,11038,5005,4701,4699,2,19,285,262,23,6033,4209,622,298,419,485
2021,Birmingham 141,E02007038,10227,4825,3715,3689,26,11,1099,1054,45,5402,3629,217,272,722,562
2021,Birmingham 142,E02007039,5990,2902,2680,2673,7,2,220,204,16,3088,2088,299,150,251,300
2021,Birmingham 143,E02007040,5152,2540,2313,2313,0,7,220,210,10,2612,1715,308,161,240,188
2021,Coventry 001,E02001958,6409,3370,2333,2317,16,7,1030,998,32,3039,1928,105,124,531,351
2021,Coventry 002,E02001959,5433,3108,2422,2410,12,2,684,668,16,2325,1492,89,104,311,329
2021,Coventry 004,E02001961,6085,2852,2083,2077,6,7,762,726,36,3233,2123,130,146,487,347
2021,Coventry 005,E02001962,5361,2832,2157,2151,6,7,668,622,46,2529,1686,133,135,330,245
2021,Coventry 006,E02001963,5046,2920,2195,2191,4,3,722,700,22,2126,1294,61,83,354,334
2021,Coventry 007,E02001964,7792,3815,2597,2581,16,8,1210,1160,50,3977,2675,122,260,571,349
2021,Coventry 008,E02001965,6519,3756,2962,2952,10,6,788,749,39,2763,1677,74,136,455,421
2021,Coventry 009,E02001966,5397,2649,2199,2194,5,6,444,392,52,2748,1914,263,129,226,216
2021,Coventry 010,E02001967,5621,3621,2888,2869,19,3,730,704,26,2000,1182,38,65,346,369
2021,Coventry 011,E02001968,6009,3201,2476,2458,18,14,711,674,37,2808,1870,149,140,359,290
2021,Coventry 012,E02001969,5205,2596,1905,1897,8,5,686,656,30,2609,1709,81,126,421,272
2021,Coventry 013,E02001970,4669,2622,1975,1969,6,1,646,618,28,2047,1161,65,103,329,389
2021,Coventry 014,E02001971,4924,2964,2246,2231,15,4,714,688,26,1960,1244,52,80,329,255
2021,Coventry 015,E02001972,8428,4128,3210,3202,8,16,902,784,118,4300,2844,362,295,489,310
2021,Coventry 016,E02001973,6633,3266,2325,2317,8,13,928,908,20,3367,2278,133,167,480,309
2021,Coventry 017,E02001974,7666,4552,3496,3474,22,2,1054,1002,52,3114,1941,76,138,514,445
2021,Coventry 018,E02001975,5992,3451,2637,2631,6,0,814,790,24,2541,1599,86,110,400,346
2021,Coventry 019,E02001976,5866,3210,2569,2565,4,5,636,610,26,2656,1629,89,131,453,354
2021,Coventry 020,E02001977,7961,3001,2033,2020,13,6,962,918,44,4960,3521,362,182,599,296
2021,Coventry 021,E02001978,5305,2986,2323,2315,8,7,656,616,40,2319,1535,112,88,314,270
2021,Coventry 022,E02001979,4594,2878,2194,2181,13,9,675,639,36,1716,977,33,69,271,366
2021,Coventry 023,E02001980,4901,3251,2633,2623,10,3,615,593,22,1650,905,38,73,258,376
2021,Coventry 024,E02001981,8858,3604,2658,2654,4,2,944,900,44,5254,3803,421,241,471,318
2021,Coventry 025,E02001982,6729,4057,3016,3002,14,2,1039,988,51,2672,1713,65,143,421,330
2021,Coventry 026,E02001983,6170,3433,2488,2468,20,1,944,902,42,2737,1782,56,108,465,326
2021,Coventry 027,E02001984,8193,4540,3417,3391,26,9,1114,1062,52,3653,2498,168,132,473,382
2021,Coventry 028,E02001985,7209,1655,989,989,0,3,663,585,78,5554,4798,256,102,247,151
2021,Coventry 029,E02001986,6267,3018,2101,2085,16,3,914,878,36,3249,2171,73,143,535,327
2021,Coventry 030,E02001987,5209,1974,1068,1050,18,0,906,854,52,3235,2447,98,87,356,247
2021,Coventry 031,E02001988,5613,1822,1096,1084,12,2,724,660,64,3791,2860,161,119,472,179
2021,Coventry 032,E02001989,4965,2708,1959,1939,20,3,746,718,28,2257,1575,57,98,281,246
2021,Coventry 033,E02001990,7448,4728,3807,3793,14,11,910,880,30,2720,1647,82,111,408,472
2021,Coventry 034,E02001991,7116,4120,3302,3275,27,4,814,764,50,2996,1976,80,94,411,435
2021,Coventry 035,E02001992,8087,4025,2993,2980,13,10,1022,992,30,4062,2704,139,208,581,430
2021,Coventry 036,E02001993,7006,3037,2339,2329,10,9,689,633,56,3969,3042,90,120,410,307
2021,Coventry 037,E02001994,6443,3676,3050,3036,14,14,612,578,34,2767,1733,140,99,388,407
2021,Coventry 038,E02001995,7508,3926,2825,2793,32,7,1094,1030,64,3582,2370,179,157,486,390
2021,Coventry 039,E02001996,5724,2517,1715,1703,12,5,797,745,52,3207,2114,129,175,467,322
2021,Coventry 040,E02001997,7017,4476,3983,3976,7,10,483,457,26,2541,1535,70,67,335,534
2021,Coventry 041,E02001998,4897,3091,2642,2638,4,4,445,431,14,1806,1117,38,54,261,336
2021,Coventry 042,E02001999,5044,2573,2274,2262,12,2,297,276,21,2471,1855,92,53,198,273
2021,Coventry 043,E02006805,6862,3589,2688,2676,12,15,886,856,30,3273,2209,134,146,451,333
2021,Dudley 001,E02002000,6773,3727,2640,2634,6,0,1087,1046,41,3046,1974,59,184,392,437
2021,Dudley 002,E02002001,5019,2808,2095,2081,14,5,708,686,22,2211,1372,42,103,348,346
2021,Dudley 003,E02002002,5890,3946,3389,3383,6,1,556,542,14,1944,1059,38,58,285,504
2021,Dudley 004,E02002003,7361,4422,3403,3385,18,7,1012,974,38,2939,1789,59,126,430,535
2021,Dudley 005,E02002004,6010,3375,2444,2432,12,9,922,894,28,2635,1684,40,135,330,446
2021,Dudley 006,E02002005,7226,3857,2773,2754,19,0,1084,1038,46,3369,2370,81,172,391,355
2021,Dudley 007,E02002006,5195,2860,2059,2051,8,3,798,762,36,2335,1448,35,123,412,317
2021,Dudley 008,E02002007,7503,4707,3596,3580,16,4,1107,1064,43,2796,1589,34,118,390,665
2021,Dudley 009,E02002008,6627,4290,3428,3424,4,8,854,808,46,2337,1601,47,116,296,277
2021,Dudley 010,E02002009,5304,2714,2067,2061,6,5,642,616,26,2590,1726,174,121,315,254
2021,Dudley 011,E02002010,6460,2836,2077,2063,14,2,757,710,47,3624,2285,172,191,593,383
2021,Dudley 012,E02002011,4937,3234,2576,2562,14,2,656,642,14,1703,928,32,79,301,363
2021,Dudley 013,E02002012,6580,3354,2410,2400,10,8,936,888,48,3226,1928,86,178,517,517
2021,Dudley 014,E02002013,5524,3624,3035,3025,10,1,588,560,28,1900,1032,32,82,284,470
2021,Dudley 015,E02002014,6260,3324,2396,2382,14,8,920,830,90,2936,1988,161,142,332,313
2021,Dudley 016,E02002015,5679,3609,2635,2620,15,8,966,928,38,2070,1317,34,66,300,353
2021,Dudley 017,E02002016,6131,3176,2187,2171,16,7,982,950,32,2955,1968,53,141,415,378
2021,Dudley 018,E02002017,6372,3510,2512,2510,2,4,994,938,56,2862,1751,87,125,491,408
2021,Dudley 019,E02002018,7439,4945,4104,4091,13,7,834,798,36,2494,1456,48,88,317,585
2021,Dudley 020,E02002019,6057,3422,2505,2489,16,9,908,864,44,2635,1780,54,122,322,357
2021,Dudley 021,E02002020,7886,5056,3842,3812,30,0,1214,1180,34,2830,1612,32,121,483,582
2021,Dudley 022,E02002021,6158,2906,1818,1804,14,2,1086,1014,72,3252,2098,105,174,536,339
2021,Dudley 023,E02002022,6888,4006,2645,2625,20,3,1358,1314,44,2882,1791,40,206,493,352
2021,Dudley 024,E02002023,4482,2884,2142,2122,20,2,740,716,24,1598,918,13,80,281,306
2021,Dudley 025,E02002024,7024,4310,3129,3107,22,9,1172,1134,38,2714,1752,58,107,396,401
2021,Dudley 026,E02002025,7034,4003,2949,2891,58,6,1048,1004,44,3031,1921,82,164,458,406
2021,Dudley 027,E02002026,5665,3636,2880,2870,10,4,752,736,16,2029,1200,40,79,321,389
2021,Dudley 028,E02002027,4572,3176,2584,2570,14,4,588,570,18,1396,895,16,81,222,182
2021,Dudley 029,E02002028,4802,3000,2310,2306,4,0,690,658,32,1802,961,27,72,327,415
2021,Dudley 030,E02002029,5075,3114,2504,2494,10,6,604,578,26,1961,1209,50,62,267,373
2021,Dudley 031,E02002030,5467,3018,2138,2126,12,0,880,842,38,2449,1485,48,112,432,372
2021,Dudley 032,E02002031,5087,2978,2265,2253,12,3,710,672,38,2109,1320,90,110,305,284
2021,Dudley 033,E02002032,8082,4543,3139,3098,41,8,1396,1294,102,3539,2232,100,146,628,433
2021,Dudley 034,E02002033,6365,3847,2955,2937,18,4,888,844,44,2518,1546,52,93,401,426
2021,Dudley 035,E02002034,6791,3849,2596,2574,22,6,1247,1220,27,2942,1688,57,146,620,431
2021,Dudley 036,E02002035,5028,3319,2808,2796,12,5,506,474,32,1709,1027,40,64,237,341
2021,Dudley 037,E02002036,5313,2724,1939,1929,10,9,776,750,26,2589,1571,121,148,431,318
2021,Dudley 038,E02002037,4907,3092,2398,2388,10,3,691,662,29,1815,1093,16,61,330,315
2021,Dudley 039,E02002038,7899,4347,3213,3187,26,12,1122,1054,68,3552,2070,59,194,661,568
2021,Dudley 040,E02002039,4935,3056,2380,2364,16,0,676,638,38,1879,1044,43,152,300,340
2021,Dudley 041,E02002040,5006,3400,2944,2930,14,4,452,436,16,1606,874,43,53,236,400
2021,Dudley 042,E02002041,5167,3317,2815,2805,10,6,496,468,28,1850,1005,56,60,286,443
2021,Dudley 043,E02002042,6617,4366,3606,3592,14,6,754,734,20,2251,1270,44,92,339,506
2021,Sandwell 001,E02002043,6653,3830,2765,2755,10,15,1050,1010,40,2823,1907,86,124,336,370
2021,Sandwell 002,E02002044,6186,3360,2607,2601,6,21,732,694,38,2826,1912,102,120,360,332
2021,Sandwell 003,E02002045,6131,3490,2536,2524,12,4,950,916,34,2641,1680,62,131,337,431
2021,Sandwell 004,E02002046,4150,2198,1564,1558,6,6,628,604,24,1952,1312,45,108,213,274
2021,Sandwell 005,E02002047,5988,3291,2496,2484,12,3,792,762,30,2697,1697,77,142,362,419
2021,Sandwell 006,E02002048,5713,3396,2824,2814,10,8,564,550,14,2317,1368,108,76,330,435
2021,Sandwell 007,E02002049,4979,2854,2134,2132,2,6,714,680,34,2125,1435,49,95,261,285
2021,Sandwell 009,E02002051,4473,2398,1648,1642,6,2,748,726,22,2075,1397,56,109,233,280
2021,Sandwell 010,E02002052,8641,4520,3445,3435,10,17,1058,1012,46,4121,2777,165,165,514,500
2021,Sandwell 011,E02002053,5056,2700,2182,2180,2,4,514,496,18,2356,1469,81,113,326,367
2021,Sandwell 012,E02002054,4722,2466,2010,2004,6,10,446,426,20,2256,1415,115,89,294,343
2021,Sandwell 013,E02002055,8630,4604,3616,3606,10,2,986,946,40,4026,2598,207,187,485,549
2021,Sandwell 014,E02002056,7410,3878,2678,2673,5,9,1191,1149,42,3532,2401,82,162,442,445
2021,Sandwell 015,E02002057,8327,4339,3275,3269,6,11,1053,999,54,3988,2516,194,244,541,493
2021,Sandwell 016,E02002058,10440,5438,4287,4269,18,9,1142,1086,56,5002,3280,276,260,674,512
2021,Sandwell 017,E02002059,9302,4704,3802,3788,14,4,898,838,60,4598,2936,250,218,611,583
2021,Sandwell 018,E02002060,5443,2782,2254,2248,6,4,524,498,26,2661,1775,154,112,295,325
2021,Sandwell 019,E02002061,5459,2663,2269,2267,2,5,389,370,19,2796,1826,225,113,289,343
2021,Sandwell 020,E02002062,6924,3268,2576,2568,8,8,684,634,50,3656,2389,248,161,465,393
2021,Sandwell 021,E02002063,7907,4216,3234,3216,18,18,964,920,44,3691,2401,200,171,526,393
2021,Sandwell 022,E02002064,9596,5505,4107,4101,6,1,1397,1360,37,4091,2751,133,183,557,467
2021,Sandwell 023,E02002065,10474,5402,4760,4744,16,24,618,588,30,5072,3301,557,246,431,537
2021,Sandwell 024,E02002066,6229,2998,2506,2498,8,4,488,468,20,3231,2113,205,144,458,311
2021,Sandwell 025,E02002067,4985,3072,2270,2252,18,6,796,744,52,1913,1194,44,80,243,352
2021,Sandwell 027,E02002069,5675,2888,2113,2103,10,1,774,734,40,2787,1722,95,131,424,415
2021,Sandwell 028,E02002070,7578,3480,2873,2869,4,9,598,551,47,4098,2635,329,192,487,455
2021,Sandwell 029,E02002071,5255,2876,2046,2032,14,6,824,806,18,2379,1499,55,133,324,368
2021,Sandwell 030,E02002072,7093,3768,2877,2867,10,5,886,848,38,3325,2010,138,179,569,429
2021,Sandwell 031,E02002073,6320,3194,2558,2554,4,6,630,604,26,3126,2056,120,121,447,382
2021,Sandwell 032,E02002074,6462,3506,2733,2729,4,13,760,720,40,2956,1890,106,143,368,449
2021,Sandwell 033,E02002075,7002,3812,2784,2768,16,10,1018,970,48,3190,1960,105,150,502,473
2021,Sandwell 034,E02002076,8477,4502,3045,2991,54,7,1450,1328,122,3975,2674,156,225,539,381
2021,Sandwell 035,E02002077,8619,4459,3276,3257,19,3,1180,1138,42,4160,2617,202,198,617,526
2021,Sandwell 036,E02002078,5287,3094,2579,2571,8,3,512,490,22,2193,1345,82,90,285,391
2021,Sandwell 037,E02002079,6843,3678,2791,2783,8,5,882,852,30,3165,1978,81,143,509,454
2021,Sandwell 038,E02002080,5728,3182,2285,2281,4,11,886,856,30,2546,1589,54,128,429,346
2021,Sandwell 039,E02006810,8760,4900,3933,3926,7,11,956,856,100,3860,2463,161,217,457,562
2021,Sandwell 040,E02006943,5443,2438,2006,2002,4,10,422,390,32,3005,2045,227,164,317,252
2021,Sandwell 041,E02006944,5696,2766,2338,2332,6,12,416,388,28,2930,1924,321,216,292,177
2021,Solihull 001,E02002081,4577,2758,2189,2179,10,7,562,542,20,1819,1085,43,72,259,360
2021,Solihull 002,E02002082,4399,1987,1377,1368,9,0,610,588,22,2412,1675,29,112,347,249
2021,Solihull 003,E02002083,5041,3264,2622,2614,8,16,626,612,14,1777,1096,51,56,187,387
2021,Solihull 004,E02002084,5085,2475,1705,1694,11,4,766,732,34,2610,1791,40,125,369,285
2021,Solihull 005,E02002085,5075,2619,1806,1788,18,7,806,772,34,2456,1665,36,105,315,335
2021,Solihull 006,E02002086,4537,2000,1319,1315,4,9,672,646,26,2537,1697,48,109,427,256
2021,Solihull 007,E02002087,4742,2106,1426,1420,6,0,680,654,26,2636,1808,38,121,364,305
2021,Solihull 008,E02002088,7263,3279,2162,2146,16,6,1111,1060,51,3984,2669,60,209,607,439
2021,Solihull 009,E02002089,6501,3872,2844,2828,16,6,1022,964,58,2629,1692,68,97,364,408
2021,Solihull 010,E02002090,4800,2960,2349,2343,6,5,606,578,28,1840,1174,75,75,242,274
2021,Solihull 011,E02002091,6245,3749,2896,2881,15,9,844,816,28,2496,1488,76,83,360,489
2021,Solihull 012,E02002092,5872,3314,2557,2547,10,11,746,728,18,2558,1555,70,92,424,417
2021,Solihull 013,E02002093,5477,3094,2463,2451,12,3,628,588,40,2383,1474,80,95,373,361
2021,Solihull 014,E02002094,4920,3172,2802,2798,4,4,366,354,12,1748,1040,56,49,222,381
2021,Solihull 015,E02002095,7041,4230,3442,3432,10,6,782,760,22,2811,1745,75,108,462,421
2021,Solihull 016,E02002096,8331,5229,4456,4434,22,10,763,724,39,3102,1711,118,109,504,660
2021,Solihull 017,E02002097,6076,3938,3276,3256,20,0,662,636,26,2138,1251,46,79,366,396
2021,Solihull 018,E02002098,7752,4703,4046,4029,17,7,650,634,16,3049,1844,90,121,440,554
2021,Solihull 019,E02002099,5648,3815,3476,3468,8,7,332,310,22,1833,1052,89,66,232,394
2021,Solihull 021,E02002101,5171,2948,2303,2289,14,5,640,620,20,2223,1293,38,93,414,385
2021,Solihull 022,E02002102,6914,4186,3493,3483,10,15,678,648,30,2728,1615,81,126,451,455
2021,Solihull 023,E02002103,5050,3278,2764,2759,5,6,508,488,20,1772,991,40,68,282,391
2021,Solihull 024,E02002104,4836,3228,2868,2860,8,2,358,342,16,1608,952,28,57,291,280
2021,Solihull 025,E02002105,6740,4552,3905,3890,15,8,639,614,25,2188,1284,47,79,314,464
2021,Solihull 026,E02002106,7857,5249,4681,4665,16,7,561,554,7,2608,1433,66,103,411,595
2021,Solihull 027,E02002107,4475,2985,2601,2589,12,9,375,365,10,1490,870,42,64,260,254
2021,Solihull 028,E02002108,7832,5324,4739,4729,10,5,580,550,30,2508,1429,53,74,399,553
2021,Solihull 029,E02002109,9625,6291,4801,4787,14,10,1480,1410,70,3334,2200,79,147,545,363
2021,Solihull 030,E02006808,5344,3302,2634,2624,10,4,664,650,14,2042,1278,52,82,277,353
2021,Walsall 001,E02002110,5586,3462,2512,2506,6,6,944,902,42,2124,1323,35,99,353,314
2021,Walsall 002,E02002111,5085,2816,1949,1928,21,10,857,830,27,2269,1356,39,85,386,403
2021,Walsall 003,E02002112,4362,2764,2154,2148,6,2,608,594,14,1598,929,25,61,261,322
2021,Walsall 004,E02002113,5117,2960,2178,2160,18,4,778,762,16,2157,1349,42,99,357,310
2021,Walsall 005,E02002114,5064,3100,2370,2352,18,4,726,696,30,1964,1047,27,83,355,452
2021,Walsall 006,E02002115,5440,3044,2218,2208,10,4,822,794,28,2396,1477,38,81,330,470
2021,Walsall 007,E02002116,5682,3666,2891,2881,10,8,767,748,19,2016,1155,39,74,298,450
2021,Walsall 008,E02002117,5187,3058,2242,2228,14,2,814,774,40,2129,1323,27,89,359,331
2021,Walsall 009,E02002118,5740,3088,2032,2025,7,3,1053,1009,44,2652,1656,46,127,380,443
2021,Walsall 010,E02002119,4904,2943,2270,2262,8,2,671,638,33,1961,1213,45,84,255,364
2021,Walsall 011,E02002120,4948,3194,2528,2512,16,4,662,654,8,1754,1176,28,62,243,245
2021,Walsall 012,E02002121,4896,2616,1772,1766,6,8,836,798,38,2280,1541,50,103,279,307
2021,Walsall 013,E02002122,5035,2762,1826,1820,6,4,932,890,42,2273,1656,54,112,214,237
2021,Walsall 014,E02002123,5171,3000,2104,2098,6,6,890,864,26,2171,1365,54,88,304,360
2021,Walsall 015,E02002124,5672,3169,2334,2328,6,3,832,798,34,2503,1396,38,109,429,531
2021,Walsall 016,E02002125,5080,2848,2015,2009,6,3,830,806,24,2232,1406,42,106,374,304
2021,Walsall 017,E02002126,4966,2471,1544,1528,16,7,920,884,36,2495,1606,50,130,407,302
2021,Walsall 018,E02002127,7028,3694,2733,2720,13,7,954,900,54,3334,2211,202,197,415,309
2021,Walsall 019,E02002128,4580,2725,2053,2049,4,1,671,645,26,1855,1071,51,71,276,386
2021,Walsall 020,E02002129,5006,3032,2293,2287,6,9,730,712,18,1974,1204,43,75,245,407
2021,Walsall 021,E02002130,5136,2751,2003,1989,14,5,743,703,40,2385,1565,82,115,335,288
2021,Walsall 022,E02002131,6523,4225,3571,3557,14,0,654,640,14,2298,1340,87,78,303,490
2021,Walsall 023,E02002132,4896,2661,1948,1940,8,2,711,671,40,2235,1419,70,90,322,334
2021,Walsall 024,E02002133,5669,2927,2316,2298,18,6,605,568,37,2742,1672,139,120,482,329
2021,Walsall 025,E02002134,7019,3750,2594,2572,22,2,1154,1098,56,3269,2136,95,160,498,380
2021,Walsall 026,E02002135,5957,2928,2222,2214,8,6,700,658,42,3029,2016,199,149,390,275
2021,Walsall 027,E02002136,6266,3444,2487,2479,8,9,948,912,36,2822,1731,215,152,427,297
2021,Walsall 028,E02002137,5072,3333,2890,2884,6,6,437,420,17,1739,942,44,58,217,478
2021,Walsall 029,E02002138,5058,2786,2396,2392,4,10,380,352,28,2272,1449,135,92,285,311
2021,Walsall 030,E02002139,8015,3610,2730,2716,14,20,860,802,58,4405,2869,281,285,549,421
2021,Walsall 031,E02002140,6256,3278,2766,2758,8,8,504,474,30,2978,1903,173,181,344,377
2021,Walsall 032,E02002141,5293,3494,2906,2898,8,10,578,556,22,1799,1035,64,65,255,380
2021,Walsall 033,E02002142,5478,2795,2091,2080,11,2,702,674,28,2683,1818,118,142,340,265
2021,Walsall 034,E02002143,7345,3814,3386,3380,6,12,416,382,34,3531,2332,282,193,351,373
2021,Walsall 035,E02002144,5661,3555,3293,3288,5,8,254,242,12,2106,1230,131,63,208,474
2021,Walsall 036,E02002145,6167,3188,2326,2312,14,10,852,818,34,2979,1954,92,174,453,306
2021,Walsall 037,E02002146,4933,2634,2182,2174,8,4,448,422,26,2299,1496,130,69,312,292
2021,Walsall 038,E02002147,6779,3702,2521,2501,20,11,1170,1114,56,3077,2098,107,131,378,363
2021,Walsall 039,E02002148,9316,5721,4462,4448,14,2,1257,1232,25,3595,2140,77,138,492,748
2021,Wolverhampton 001,E02002149,8145,4568,3382,3358,24,8,1178,1138,40,3577,2140,101,172,508,656
2021,Wolverhampton 002,E02002150,4520,2524,1922,1914,8,8,594,574,20,1996,1312,53,72,286,273
2021,Wolverhampton 003,E02002151,4414,2214,1554,1540,14,6,654,626,28,2200,1403,41,107,415,234
2021,Wolverhampton 004,E02002152,4565,2230,1608,1608,0,0,622,604,18,2335,1584,48,108,322,273
2021,Wolverhampton 005,E02002153,6107,3407,2374,2365,9,1,1032,990,42,2700,1628,39,96,417,520
2021,Wolverhampton 006,E02002154,5702,3216,2261,2233,28,7,948,902,46,2486,1640,119,115,345,267
2021,Wolverhampton 007,E02002155,4487,2042,1364,1356,8,4,674,660,14,2445,1666,105,164,257,253
2021,Wolverhampton 008,E02002156,6657,3814,2944,2932,12,6,864,836,28,2843,1752,76,113,437,465
2021,Wolverhampton 009,E02002157,6348,3814,3029,3011,18,1,784,764,20,2534,1574,87,101,380,392
2021,Wolverhampton 010,E02002158,6079,3368,2510,2500,10,4,854,818,36,2711,1586,69,110,437,509
2021,Wolverhampton 011,E02002159,4530,2245,1606,1602,4,3,636,608,28,2285,1562,95,117,267,244
2021,Wolverhampton 012,E02002160,6020,3607,2871,2857,14,9,727,694,33,2413,1555,85,80,317,376
2021,Wolverhampton 013,E02002161,5262,2632,1978,1962,16,2,652,628,24,2630,1750,176,121,386,197
2021,Wolverhampton 014,E02002162,6396,3845,3212,3194,18,2,631,602,29,2551,1349,98,111,403,590
2021,Wolverhampton 015,E02002163,8893,3953,2889,2879,10,11,1053,988,65,4940,3315,244,224,703,454
2021,Wolverhampton 016,E02002164,4668,1931,1408,1402,6,3,520,484,36,2737,1907,200,136,278,216
2021,Wolverhampton 017,E02002165,6401,2812,1970,1952,18,10,832,796,36,3589,2458,186,166,522,257
2021,Wolverhampton 018,E02002166,7213,3450,2468,2454,14,6,976,908,68,3763,2468,122,164,546,463
2021,Wolverhampton 019,E02002167,5526,3272,2536,2526,10,6,730,698,32,2254,1316,70,114,403,351
2021,Wolverhampton 020,E02002168,8369,3516,2468,2454,14,10,1038,976,62,4853,3294,325,241,639,354
2021,Wolverhampton 021,E02002169,7189,4476,3806,3780,26,8,662,636,26,2713,1601,116,91,401,504
2021,Wolverhampton 022,E02002170,4986,2801,2147,2140,7,2,652,638,14,2185,1462,76,83,247,317
2021,Wolverhampton 023,E02002171,6024,3160,2325,2321,4,7,828,800,28,2864,1791,114,128,402,429
2021,Wolverhampton 026,E02002174,6244,3506,2849,2833,16,3,654,622,32,2738,1673,81,121,437,426
2021,Wolverhampton 027,E02002175,6012,3080,2300,2292,8,10,770,730,40,2932,1937,106,132,392,365
2021,Wolverhampton 028,E02002176,6247,3438,2612,2600,12,3,823,784,39,2809,1796,57,126,458,372
2021,Wolverhampton 029,E02002177,8707,4462,3189,3167,22,9,1264,1200,64,4245,2716,263,209,589,468
2021,Wolverhampton 030,E02002178,6533,3862,3464,3456,8,10,388,366,22,2671,1658,205,90,299,419
2021,Wolverhampton 031,E02002179,5269,3292,2719,2705,14,11,562,534,28,1977,1207,62,71,294,343
2021,Wolverhampton 032,E02002180,5217,2940,2376,2362,14,4,560,538,22,2277,1401,77,101,291,407
2021,Wolverhampton 033,E02002181,6446,3547,2480,2466,14,2,1065,1012,53,2899,1963,64,137,367,368
2021,Wolverhampton 034,E02002182,5213,2831,2177,2175,2,8,646,632,14,2382,1562,86,94,326,314
2021,Wolverhampton 035,E02006894,10691,5467,4395,4383,12,5,1067,1000,67,5224,3371,418,240,601,594
